%%%%%%%%%%%%%%%
%......P....o.%
%%%%%%%%%%%%%%%